0,0,0,0,0,0,0,0,0,0
0,12,13,13,13,13,13,13,14,0
0,24,25,25,25,25,25,25,26,0
0,24,25,25,25,25,25,25,26,0
0,24,25,25,25,25,25,25,26,0
0,24,25,25,25,41,37,37,38,0
0,24,25,25,25,26,1,1,1,0
0,24,25,25,25,26,1,2,1,0
0,36,37,37,37,38,1,1,1,0
0,0,0,0,0,0,0,0,0,0
